AGRICULTURAL BANK OF CHINA HEAD OFFICE - BEIJING[中国农业银行股份有限公司]
AGRICULTURAL BANK OF CHINA LIMITED - SHANGHAI TREASURY DEPARTMENT[中国农业银行股份有限公司]
AGRICULTURAL DEVELOPMENT BANK OF CHINA (HEAD OFFICE) - BEIJING [中国农业发展银行]
ANHUI RURAL CREDIT UNION - HEFEI [安徽省农村信用社联合社]
ANJI RURAL CREDIT UNION [安吉县农村信用合作联社]
AUSTRALIA AND NEW ZEALAND BANK (CHINA) CO LIMITED - SHANGHAI [澳大利亚和新西兰银行(中国)有限公司]
BANGKOK BANK (CHINA) COMPANY LINITED - SHANGHAI [盘谷银行(中国)有限公司]
BANK OF ANSHAN - AN SHAN [鞍山银行股份有限公司]
BANK OF BEIJING ASSET MANAGEMENT - BEIJING [北京银行股份有限公司资产管理部]
BANK OF BEIJING CO. LTD. - BEIJING[北京银行股份有限公司]
BANK OF CANGZHOU [沧州银行股份有限公司]
BANK OF CHANGSHA [长沙银行股份有限公司]
BANK OF CHENGDU - CHENGDU [成都银行股份有限公司]
BANK OF CHINA ASSET MANAGEMENT - SHANGHAI [中国银行股份有限公司资产管理部]
BANK OF CHINA INVESTMENT MANAGEMENT - SHANGHAI [中银基金管理有限公司]
BANK OF CHINA LIMITED SHANGHAI TREASURY DEPARTMENT[中国银行股份有限公司]
BANK OF CHONGQING - CHONGQING [重庆银行股份有限公司]
BANK OF COMMUNICATIONS - SHENZHEN BRANCH [交通银行深圳分行]
BANK OF COMMUNICATIONS (HEAD OFFICE) -SHANGHAI[交通银行股份有限公司]
BANK OF COMMUNICATIONS ASSET MANAGEMENT DEPARTMENT [交通银行股份有限公司资产管理部]
BANK OF COMMUNICATIONS SHANGHAI MUNICIPAL BRANCH  [交通银行股份有限公司上海市分行]
BANK OF DALIAN - DALIAN[大连银行股份有限公司]
BANK OF DANDONG - DANDONG [丹东银行股份有限公司]
BANK OF DONGGUAN - DONGGUAN [东莞银行股份有限公司]
BANK OF EAST ASIA (CHINA) LIMITED - SHANGHAI [东亚银行(中国)有限公司]
BANK OF FUSHUN - LIAONING[抚顺银行]
BANK OF FUXIN CO., LTD. - FUXIN[阜新银行股份有限公司]
BANK OF GANZHOU - GANZHOU [赣州银行股份有限公司]
BANK OF GUANGZHOU CO.,LTD - GUANGZHOU[广州银行股份有限公司]
BANK OF GUIYANG - GUIYANG[贵阳银行股份有限公司]
BANK OF HANDAN - HANDAN [邯郸银行股份有限公司]
BANK OF HANGZHOU - HANGZHOU   [杭州银行股份有限公司]
BANK OF HEBEI CO., LTD.[河北银行股份有限公司]
BANK OF HUZHOU - HUZHOU[湖州银行股份有限公司]
BANK OF INNER MONGOLIA - HOHHOT[内蒙古银行股份有限公司]
BANK OF JIANGSU CO LTD - NANJING [江苏银行股份有限公司]
BANK OF JILIN CO., LTD - CHANGCHUN [吉林银行股份有限公司]
BANK OF JINHUA CO.,LTD - JINHUA [金华银行股份有限公司]
BANK OF JINZHOU - JINZHOU [锦州银行股份有限公司]
BANK OF LANGFANG - LANGFANG [廊坊银行股份有限公司]
BANK OF LIAOYANG - LIAOYANG [辽阳银行股份有限公司]
BANK OF LIU ZHOU CO., LTD. - LIUZHOU[柳州银行股份有限公司]
BANK OF LUOYANG[洛阳银行股份有限公司]
BANK OF NANCHANG - NANCHANG [南昌银行股份有限公司]
BANK OF NANJING CO LTD - NANJING[南京银行股份有限公司]
BANK OF NANYANG CO. LTD. - NANYANG [南阳银行股份有限公司]
BANK OF NINGBO - NINGBO[宁波银行股份有限公司]
BANK OF NINGBO [宁波银行股份有限公司]
BANK OF NINGXIA - NINGXIA [宁夏银行股份有限公司]
BANK OF NOVA SCOTIA - GUANGZHOU [加拿大丰业银行有限公司广州分行]
BANK OF PUYANG - PUYANG [濮阳银行股份有限公司]
BANK OF QINGDAO - QINGDAO [青岛银行股份有限公司]
BANK OF RIZHAO - RIZHAO[日照银行股份有限公司]
BANK OF RUIFENG - SHAOXING [浙江绍兴瑞丰农村商业银行股份有限公司]
BANK OF SHANGHAI (HEAD OFFICE) - SHANGHAI[上海银行股份有限公司]
BANK OF SHAOXING - SHAOXING[绍兴银行股份有限公司]
BANK OF SHIZUISHAN[石嘴山银行股份有限公司]
BANK OF SUZHOU CO. LTD - SUZHOU [苏州银行股份有限公司]
BANK OF TOKYO-MITSUBISHI UFJ (CHINA) LTD[三菱东京日联银行（中国）有限公司]
BANK OF WEIFANG CO.,LTD - WEIFANG [潍坊银行股份有限公司]
BANK OF WUHAI  - WUHAI [乌海银行股份有限公司]
BANK OF XI'AN[西安银行股份有限公司]
BANK OF XING TAI [邢台银行股份有限公司]
BANK OF XINYANG - XINYANG[信阳银行股份有限公司]
BANK OF YINGKOU - YINGKOU [营口银行股份有限公司]
BANK OF ZHENGZHOU - ZHENGZHOU [郑州银行]
BANK OF ZHUMADIAN CO., LTD. - ZHUMADIAN [驻马店银行股份有限公司]
BAOJI WEIBIN RURAL CREDIT UNION - BAOJI [宝鸡市渭滨区农村信用合作联社]
BAOSHANG BANK CO.,LTD - BAOTOU  [包商银行股份有限公司]
BARCLAYS BANK PLC - SHANGHAI BRANCH [英国巴克莱银行有限公司上海分行]
BEIJING RURAL COMMERCIAL BANK - BEIJING  [北京农村商业银行股份有限公司 ]
BENXI CITY COMMERCIAL BANK - BENXI[本溪市商业银行股份有限公司]
BNP PARIBAS (CHINA) LIMITED[法国巴黎银行(中国)有限公司]
BOSERA ASSET MANAGEMENT - SHENZHEN [博时基金管理公司]
CHANG'AN BANK - XI'AN [长安银行股份有限公司]
CHANGSHA SHI RURAL CREDIT UNION - CHANGSHA [长沙市农村信用合作社联合社]
CHANGSHA TIANXIN RURAL COOPERATIVE BANK - CHANGSHA [长沙天心农村合作银行]
CHANGSHA XIANDAO RURAL COMMERCIAL BANK - CHANGSHA [长沙先导农村商业银行股份有限公司]
CHANGSHA YUHUA RURAL CO. BANK- CHANGSHA [长沙雨花农村合作银行]
CHENGDU RURAL COMMERCAIL BANK - CHENGDU [成都农村商业银行股份有限公司]
CHINA ASSET MANAGEMENT CO., LTD. - BEIJING  [华夏基金管理公司]
CHINA BOHAI BANK CO., LTD - TIANJIN [渤海银行股份有限公司]
CHINA CITIC BANK (HEAD OFFICE) - BEIJING[中信银行股份有限公司]
CHINA CONSTRUCTION BK CORP. TREASURY (H.O.) BEIJING[中国建设银行股份有限公司]
CHINA DEVELOPMENT BANK - BEIJING [国家开发银行 ]
CHINA EVERBRIGHT BANK (HEAD OFFICE) - BEIJING[中国光大银行股份有限公司]
CHINA GUANGFA BANK CO., LTD - GUANGZHOU[广发银行股份有限公司]
CHINA LIFE ASSET MANAGEMENT CO LTD - BEIJING [中国人寿资产管理有限公司]
CHINA LIFE INSURANCE CO LTD - BEIJING [中国人寿保险股份有限公司]
CHINA LIFE PENSION COMPANY LIMITED-BEIJING [中国人寿养老保险股份有限公司]
CHINA MERCHANTS BANK (H.O.) - SHENZHEN[招商银行股份有限公司]
CHINA MINSHENG BANKING CORP., LTD - BEIJING    [中国民生银行股份有限公司]
CHINA MINSHENG BANKING CORP., LTD - BEIJING [中国民生银行股份有限公司]
CHINA MINSHENG BANKING CORP., LTD. - BEIJING [中国民生银行股份有限公司]
CHINA UNITED PROPERTY INSURANCE COMPANY LIMITED - BEIJING [中华联合财产保险股份有限公司]
CHINA ZHESHANG BANK - HANGZHOU [浙商银行股份有限公司]
CHINESE MERCANTILE BANK - SHENZHEN [华商银行]
CHONGQING RURAL COMMERCIAL BANK - CHONGQING [重庆农村商业银行股份有限公司]
CITIBANK (CHINA) CO LTD[花旗银行（中国）有限公司]
CITIC SECURITIES CO., LTD., TREASURY DEPT - BEIJING [中信证券股份有限公司资金运营部]
CREDIT AGRICOLE CIB (CHINA) LTD - SHANGHAI[东方汇理银行（中国）有限公司]
DBS BANK (CHINA) LTD[星展银行（中国）有限公司]
DENGFENG RURAL CREDIT UNION - ZHENGZHOU [登封市农村信用合作联社]
DEUTSCHE BANK (CHINA) LTD [德意志银行（中国）有限公司 ]
DEZHOU BANK - DEZHOU [德州银行股份有限公司]
DONGAN RURAL CREDIT UNION [东安县农村信用合作联社]
DONGGUAN RURAL COMMERCIAL BANK - DONGGUAN  [东莞农村商业银行股份有限公司]
DONGTAI RURAL COMMERCIAL BANK - DONGTAI[江苏东台农村商业银行股份有限公司]
DONGYANG RURAL CREDIT COOPERATIVES UNION - JINHUA [东阳市农村信用合作联社]
DONGYING BANK - DONGYING [东营银行股份有限公司]
E FUND MANAGEMENT CO LTD - GUANGZHOU [易方达基金管理有限公司]
ESSENCE SECURITIES CO LTD - BEIJING [安信证券股份有限公司]
EVERGROWING BANK CO LTD - SHANGHAI [恒丰银行股份有限公司]
FIRST SINO BANK - SHANGHAI[华一银行 ]
FUDIAN  BANK - KUMING [富滇银行股份有限公司]
FUJIAN HAIXIA BANK - FUZHOU[福建海峡银行股份有限公司]
FUZHOU RURAL COMMERCIAL BANK - FUZHOU [福建福州农村商业银行股份有限公司]
GANSU RURAL CREDIT UNION - LANZHOU [甘肃省农村合作金融结算服务中心]
GFFUND MANAGEMENT CO LTD - GUANGZHOU [广发基金管理有限公司]
GREAT WALL LIFE INSURANCE CO.,LTD. [长城人寿保险股份有限公司]
GUANGDONG HUAXING BANK - GUANGZHOU [广东华兴银行股份有限公司]
GUANGDONG NANYUE BANK CO.,LTD [广东南粤银行股份有限公司]
GUANGZHOU RURAL COMMERCIAL BANK - GUANGZHOU [广州农村商业银行股份有限公司]
GUILIN BANK CO. LTD - GUILIN[桂林银行股份有限公司]
GUIZHOU RURAL CREDIT UNION -GUIYANG [贵州省农村信用社联合社]
GUOTAI ASSET MANAGEMENT CO LTD - SHANGHAI [国泰基金管理有限公司]
GUOTAI JUNAN SECURITIES - SHANGHAI [国泰君安证券股份有限公司]
GUOTAI JUNAN SECURITIES ASSET MANAGEMENT DEPARTMENT [国泰君安证券股份有限公司资产管理部]
HAIKOU RURAL COMMERCIAL BANK - HAIKOU [海口农村商业银行股份有限公司]
HAINING RURAL CREDIT UNION - HAINING [海宁市农村信用合作联社]
HANA BANK (CHINA) CO LTD[韩亚银行（中国）有限公司]
HANCHENG RURAL CREDIT UNION - WEINAN [韩城市农村信用合作联社]
HANDAN YONGNIAN RURAL CREDIT COOPERATION- HANDAN [永年县农村信用联社股份有限公司]
HANG SENG BANK (CHINA) LIMITED[恒生银行（中国）有限公司]
HANGZHOU UNITED BANK - HANGZHOU [杭州联合银行]
HANKOU BANK - WUHAN[汉口银行股份有限公司]
HEFEI SCIENCE & TECHNOLOGY RURAL COMMERCIAL BANK - HEFEI [合肥科技农村商业银行股份有限公司]
HEILONGJIANG RURAL CREDIT UNION - HARBIN [黑龙江省农村信用社联合社]
HENAN ANYANG RURAL CREDIT UNION - ANYANG [河南安阳县农村信用合作联社　　]
HENAN RURAL CREDIT UNION [河南省农村信用社联合社]
HENAN XUNXIAN RURAL CREDIT UNION - XUANXIAN [浚县农村信用合作社联合社]
HENGSHUI RURAL CREDIT UNION - HENGSHUI [衡水市农村信用合作社联合社]
HSBC BANK (CHINA) CO LTD - SHANGHAI[汇丰银行（中国）有限公司]
HU NAN LONG SHAN RURAL CREDIT UNION [龙山县农村信用合作联社]
HUA XIA BANK (HEAD OFFICE) - BEIJING[华夏银行股份有限公司]
HUANGGANG RURAL CREDIT COOPERATIVE UNION - HUANGGANG [黄冈市农村信用合作社联合社]
HUANGSHI RURAL COMMERCIAL BANK COMPANY LIMITED [黄石农村商业银行股份有限公司]
HUARONG XIANGJIANG BANK CORPORATION LIMITED - CHANGSHA [华融湘江银行股份有限公司]
HUBEI SUIZHOU RURAL COMMERCIAL BANK CO. LTD.  - SUIZHOU [湖北随州农村商业银行股份有限公司]
HUBEI XIANGYANG RURAL COMMERCIAL BANK - XIANGYANG [湖北襄阳农村商业银行股份有限公司]
HUISHANG BANK CORPORATION LTD- HEFEI[徽商银行股份有限公司]
HUITIANFU FUND MANAGEMENT CO LTD - SHANGHAI [汇添富基金管理有限公司]
HUNAN DONGKOU RURAL COMMERCIAL BANK CO.,LTD.[湖南洞口农村商业银行股份有限公司]
HUNAN GUIYANG RURAL CREDIT COOPERATIVE - CHENZHOU [桂阳县农村信用合作联社]
HUNAN LIUYANG RURAL COMMERCIAL BANK - LIUYANG[湖南浏阳农村商业银行股份有限公司]
HUNAN RURAL CREDIT COOPERATIVES UNION [湖南省农村信用社联合社]
HUNAN XINGSHA RURAL COMMERCIAL BANK - CHANGSHA[湖南星沙农村商业银行股份有限公司]
HUNAN YIZHANG RURAL COMMERCIAL BANK - CHENZHOU [湖南宜章农村商业银行股份有限公司]
INDUSTRIAL AND COMMERCIAL BANK OF CHINA LTD ASSET MANAGEMENT DEPARTMENT - BEIJING [中国工商银行股份有限公司资产管理部
INDUSTRIAL AND COMMERCIAL BANK OF CHINA LTD. HEAD OFFICE - BEIJING[中国工商银行股份有限公司]
INDUSTRIAL BANK CO.,  LTD.[兴业银行股份有限公司]
ING BANK N.V. - SHANGHAI BRANCH[荷兰安智银行股份有限公司上海分行]
JIANDE RURAL CREDIT UNION- HANGZHOU [建德市农村信用合作联社]
JIANG SU SU QIAN MIN FENG RURAL COMMERCIAL BANK [江苏宿迁民丰农村商业银行股份有限公司]
JIANGSU CHANGJIANG COMMERCIAL BANK  - TAIZHOU [江苏长江商业银行股份有限公司]
JIANGSU HAIAN RURAL COMMERCIAL  BANK - HAIAN [江苏海安农村商业银行股份有限公司]
JIANGSU JIANGNAN RURAL COMMERCIAL BANK CO. LTD - CHANGZHOU  [江苏江南农村商业银行股份有限公司]
JIANGSU QIDONG RURAL COMMERCIAL  BANK - NANTONG [江苏启东农村商业银行股份有限公司]
JIANGSU XINGHUA RURAL COMMERCIAL BANK CO.LTD - XINGHUA [江苏兴化农村商业银行股份有限公司]
JIANGSU YIXING RURAL COMMERCIAL BANK - YIXING [江苏宜兴农村商业银行股份有限公司]
JIANGXI RURAL CREDIT UNION - NANCHANG [江西省农村信用社联合社]
JILIN HUANCHENG RURAL CREDIT COOPERATIVE ASSOCIATION - JILIN [吉林市环城农村信用合作社联合社]
JILIN PROVINCE RURAL CREDIT UNION - JILIN [吉林省农村信用社联合社]
JINCHENG BANK CO.,LTD - JINCHENG[晋城银行股份有限公司]
JINGMEN RURAL CREDITCAL UNION - JINGMEN [荆门市农村信用合作社联合社]
JINSHANG BANK - TAIYUAN  [晋商银行股份有限公司]
JINZHONG JINGJI KAIFA RURAL CREDIT UNION - JINZHONG [晋中经济开发区农村信用合作联社]
JINZHOU RURAL CREDIT UNION [晋州市农村信用合作联社]
JPMORGAN CHASE BANK ( CHINA) COMPANY LIMITED[摩根大通银行（中国）有限公司]
KUNLUN BANK[昆仑银行股份有限公司]
LANGFANG RURAL CREDIT UNION [廊坊市城郊农村信用合作联社]
LESHAN CITY COMMERCIAL BANK - LESHAN [乐山市商业银行]
LIAONING RURAL CREDIT UNION - SHENYANG [辽宁省农村信用社联合社]
LINSHANG BANK - LINYI [临商银行股份有限公司]
LONGJIANG BANK C0RPORATION  - QIQIHAR [龙江银行股份有限公司]
LUCHENG RUAL COMMERCIAL BANK - WENZHOU [浙江温州鹿城农村商业银行股份有限公司]
LUOHE BANK - LUOHE [漯河银行股份有限公司]
LUZHOU CITY COMMERCIAL BANK [泸州市商业银行]
MAYBANK SHANGHAI BRANCH [马来西亚马来亚银行有限公司上海分行]
MENG JIN RURAL CREDIT COOPERATIVES - XINGTAI [孟津县农村信用合作联社]
METROPOLITAN BANK (CHINA) LTD- NANJING [首都银行(中国)有限公司]
MIANYANG COMMERCIAL BANK CO LTD - MIANYANG [绵阳市商业银行]
MINSHENG LIFE INSURANCE CO LIMITED  - BEIJING [民生人寿保险股份有限公司 ]
MINSHENG SECURITIES  - BEIJING [民生证券股份有限公司]
MIZUHO CORPORATE BANK (CHINA) LTD - SHANGHAI[瑞穗实业银行（中国）有限公司]
MORGAN STANLEY BANK INTERNATIONAL (CHINA) LIMITED - ZHUHAI [摩根士丹利国际银行（中国）有限公司 ]
NANCHONG COMMERCIAL BANK - NANCHONG [南充市商业银行]
NANHAI RURAL COMMERCIAL BANK - FOSHAN [广东南海农村商业银行股份有限公司]
NANTONG RURAL COMMERCIAL BANK - NANTONG [江苏南通农村商业银行股份有限公司]
NANYANG COMMERCIAL BANK (CHINA) LIMITED - SHANGHAI [南洋商业银行（中国）有限公司]
NEW CHINA ASSET MANAGEMENT CO LTD - BEIJING [新华资产管理股份有限公司]
NING XIANG RURAL COMMERCIAL BANK - NING XIANG[湖南宁乡农村商业银行股份有限公司]
OCBC (CHINA) CO LTD - SHANGHAI[华侨银行（中国）有限公司]
PACIFIC ASSET MANAGEMENT CO., LTD. - SHANGHAI [太平洋资产管理有限责任公司]
PANZHIHUA CITY COMMERCIAL BANK - PANZHIHUA [攀枝花市商业银行]
PENGHUA FUND MANAGEMENT CO LTD - SHENZHEN [鹏华基金管理有限公司]
PICC ASSET MANAGEMENT CO LTD - SHANGHAI [中国人保资产管理股份有限公司 ]
PING AN BANK CO., LTD. (FORMERLY SHENZHEN DEVELOPMENT BANK CO., LTD.)[平安银行股份有限公司]
PINGAN SEC COMPANY LIMITED - SHENZHEN [平安证券有限责任公司]
PINGAN TRUST CO LTD - SHENZHEN [平安信托投资有限责任公司]
PINGDING RURAL CREDIT COOPERATIVES UION - PINGDING [平定县农村信用合作联社]
POSTAL SAVINGS BANK OF CHINA - BEIJING[中国邮政储蓄银行]
QILU BANK CO LTD - JINAN [齐鲁银行股份有限公司]
QIN HUANG DAO COMMERCIAL BANK [秦皇岛市商业银行]
QINDU RURAL CREDIT UNION - XIANYANG [咸阳市秦都区农村信用合作联社]
QINGCHUAN RURAL CREDIT UNION-GUANGYUAN [青川县农村信用合作联社]
QISHANG BANK - ZIBO[齐商银行股份有限公司]
QIYANG RURAL CREDIT UNION  [祁阳县农村信用合作联社]
RABOBANK NEDERLAND - SHANGHAI [荷兰合作银行有限公司上海分行]
RUDONG RURAL COMMERCIAL BANK - NANTONG[江苏如东农村商业银行股份有限公司]
RUGAO RURAL COMMERCIAL BANK - RUGAO [江苏如皋农村商业银行股份有限公司]
RURAL COMMERCIAL BANK OF SHISHI - NANPING [福建石狮农村商业银行股份有限公司]
RURAL COMMERCIAL BANK OF WEIHAI [山东威海农村商业银行股份有限公司]
RURAL COOPERATIVE  BANK OF LONGKONG SHANDONG [山东龙口农村合作银行]
RUSHAN RURAL CREDIT UNION [乳山市农村信用合作社联合社]
SANXIA RURAL COMMERCIAL BANK - YICHANG [三峡农村商业银行股份有限公司]
SHANDONG ZHANGDIAN RURAL COMMERICAL BANK - ZIBO [山东张店农村商业银行股份有限公司]
SHANGHAI PUDONG DEVELOPMENT BANK (HEAD OFFICE) - SHANGHAI[上海浦东发展银行股份有限公司]
SHANGHAI PUDONG DEVELOPMENT BANK ASSET MANAGEMENT - SHANGHAI [上海浦东发展银行股份有限公司资产管理部]
SHANGHAI RURAL COMMERCIAL BANK ASSET MANAGEMENT - SHANGHAI [上海农村商业银行股份有限公司资产管理部]
SHANGHAI RURAL COMMERCIAL BANK- SHANGHAI [上海农村商业银行股份有限公司 ]
SHANXI YUCI RURAL COMMERCIAL BANK[山西榆次农村商业银行股份有限公司]
SHENGJING BANK CO LTD - SHENYANG [盛京银行股份有限公司]
SHENZHEN RURAL COMMERCIAL BANK - SHENZHEN [深圳农村商业银行]
SHEXIAN RURAL CREDIT UNION [歙县农村信用合作社联合社]
SHIJIAZHUANG RURAL CREDIT COOPERATIVE - SJZ [石家庄市农村信用合作社联合社]
SHINHAN BANK (CHINA) LTD [新韩银行（中国）有限公司]
SICHUAN RURAL CREDIT UNION - CHENGDU[四川省农村信用社联合社]
SINATAY LIFE INSURANCE COMPANY, LTD - SHANGHAI [信泰人寿保险股份有限公司]
SKANDINAVISKA ENSKILDA BANKEN AB (PUBL) SHANGHAI BRANCH  [瑞典北欧斯安银行有限公司上海分行]
SOCIETE GENERALE (CHINA) LIMITED[法国兴业银行（中国）有限公司]
SONGYUAN NINGJIANG RURAL CREDIT UNION - SONGYUAN [松原市宁江区农村信用合作联社]
STANDARD CHARTERED BANK (CHINA) LTD - SHANGHAI [渣打银行（中国）有限公司 ]
SUMITOMO MITSUI BANKING CORPORATION (CHINA) LIMITED - SHANGHAI [三井住友银行（中国）有限公司]
SUNSHINE INSURANCE GROUP CORPORATION LIMITED - BEIJING [阳光保险集团股份有限公司]
SUNSHINE PROPERTY AND CASUALTYINSURANCE COMPANY LIMITED - BEIJING [阳光财产保险股份有限公司]
SWEDBANK - SHANGHAI BRANCH [瑞典银行有限公司上海分行]
TAIAN COMMERCIAL BANK - TAIAN [泰安市商业银行股份有限公司]
TAIKANG ASSET MANAGEMENT CO LTD - BEIJING [泰康资产管理有限责任公司]
TAIKANG LIFE INSURANCE - BEIJING [泰康人寿保险股份有限公司]
TANGHE RURAL CREDIT UNION - NANYANG [唐河县农村信用合作联社]
THE EXPORT - IMPORT  BANK OF CHINA - BEIJING[中国进出口银行]
THE ROYAL BANK OF SCOTLAND (CHINA) CO LTD HEAD OFFICE - SHANGHAI [苏格兰皇家银行(中国)有限公司]
TIANJIN BANK - TIANJIN [天津银行股份有限公司]
TIANJIN BINHAI RURAL COMMERCIAL BANK CORPORATION -  TIANJIN [天津滨海农村商业银行股份有限公司]
TIANJIN RURAL COMMERCIAL BANK - TIANJIN[天津农村商业银行股份有限公司]
TIELING COMMERCIAL BANK - TIELING [铁岭市商业银行股份有限公司]
TONGHUA RURAL CREDIT UNION - TONGHUA [通化市郊区农村信用合作联社]
TONGJIANG RURAL CREDIT UNION - BAZHONG[通江县农村信用合作联社]
UNITED OVERSEAS BANK (CHINA) LIMITED[大华银行（中国）有限公司 ]
WEIFANG RURAL CREDIT COOPERATIVE - WEIFANG  [潍坊市农村信用合作社联合社]
WEIHAI CITY COMMERCIAL BANK - WEIHAI [威海市商业银行]
WOORI BANK （CHINA） LIMITED HEAD OFFICE- BEIJING [友利银行(中国)有限公司]
WUHAN RURAL COMMERCIAL BANK  - WUHAN [武汉农村商业银行股份有限公司]
WUJIANG RURAL COMMERCIAL BANK - SHUZHOU [江苏吴江农村商业银行股份有限公司]
WULUMUQI RURAL CREDIT UNION - URUMQI [乌鲁木齐市农村信用合作社联合社]
WUWEI RURAL COMMERCIAL BANK - WUWEI [安徽无为农村商业银行股份有限公司]
WUXI RURAL COMMERCIAL BANK - WUXI [无锡农村商业银行股份有限公司]
XIAMEN BANK - XIAMEN [厦门银行股份有限公司]
XIAMEN INTERNATIONAL BANK - XIAMEN [厦门国际银行股份有限公司]
XIANGFAN CITY COMMERCIAL BANK - XIANGFAN  [襄樊市商业银行股份有限公司]
XIAOSHAN RURAL COOPERATIVE BK - XIAOSHAN [浙江萧山农村合作银行]
XINING RURAL COMMERIAL BANK - XINING [青海西宁农村商业银行股份有限公司]
XINJIANG CHANGJI RURAL CREDIT UNION [昌吉市农村信用合作联社]
YAAN YUCHENG RURAL CREDIT UNION - YAAN [雅安市雨城区农村信用合作联社]
YANGQUAN RURAL CREDIT UNION [阳泉市郊区农村信用合作联社]
YANGZHOU RURAL COMMERCIAL BANK - YANGZHOU [江苏扬州农村商业银行股份有限公司]
YAODU RURAL COMMERCIAL BANK CO., LTD.- LINFEN [山西尧都农村商业银行股份有限公司]
YUEQING RURAL COOPERATIVE BANK - YUEQING [浙江乐清农村合作银行]
YUNNAN RURAL CREDIT UNION - YUNNAN [云南省农村信用社联合社]
YUXIAN RURAL COMMERCIAL BANK[山西盂县农村商业银行股份有限公司]
ZHANGJIAGANG RURAL COMMERCIAL BANK - ZHANGJIAGANG [江苏张家港农村商业银行股份有限公司]
ZHEJIANG CHANGXING RURAL COOPERATIVE BANK - HUZHOU [浙江长兴农村合作银行]
ZHEJIANG CHOUZHOU COMMERCIAL BANK CO LTD[浙江稠州商业银行股份有限公司]
ZHEJIANG FUYANG RURAL COOPERATIVE BANK - HANGZHOU [浙江富阳农村合作银行]
ZHEJIANG MINTAI COMMERCIAL BANK - HANGZHOU [浙江民泰商业银行股份有限公司]
ZHEJIANG PINGHU RURAL COOPERATIVE BANK [浙江平湖农村合作银行]
ZHEJIANG RUIAN RURAL COOPERATIVE BANK - WENZHOU [浙江瑞安农村合作银行]
ZHEJIANG RURAL CREDIT UNION - HANGZHOU [浙江省农村信用合作社联合社]
ZHEJIANG SHENGZHOU RURAL COOPERATIVE BANK [浙江嵊州农村合作银行]
ZHEJIANG TAILONG COMMERCIAL BANK TRESURY DEPT - SHANGHAI[浙江泰隆商业银行股份有限公司]
ZHEJIANG TAIZHOU JIAOJIANG RURAL COOPERATIVE BANK - TAIZHOU [浙江台州椒江农村合作银行]
ZHEJIANG TAIZHOU LUQIAO RURAL COOPERATIVE BANK [浙江台州路桥农村合作银行]
ZHEJIANG XINCHANG RURAL COOPERATIVE BANK - SHAOXING [浙江新昌农村合作银行]
ZHEJIANG YONGKANG RURAL COOPERATIVE BANK - JINHUA [浙江永康农村合作银行]
ZHEJIANG ZHOUSHAN PUTUO RURAL COOPERATIVE BANK - ZHOUSHAN [浙江舟山普陀农村合作银行]
ZHEJIANG ZHUJI RURAL COOPERATIVE BANK - ZHUJI [浙江诸暨农村合作银行]
ZHEN PING RURAL CREDIT UNION - NANYANG [镇平县农村信用合作联社]
ZHENGZHOU CITY AND RURAL CREDIT COOPERATIVE - ZZH [郑州市市郊农村信用合作联社]
ZHUHAI GREE GROUP FINANCE CO., LTD. [珠海格力集团财务有限责任公司]
ZIJIN RURAL COMMERCIAL BANK - NANJING [江苏紫金农村商业银行股份有限公司]
ZUNYI CITY COMMERCIAL BANK - ZUNYI [遵义市商业银行]
ZUOQUAN RURAL CREDIT UNION- JINZHONG [左权县农联社]